111111111111111111111
130000100000100000001
101110101110101111101
101000100010001010001
101111111011101010111
100010001000100010101
111010111000111110101
100000100010001000001
101111100011111011111
100000001000100000001
111111111111111111121